################
#..............#
#..C...........#
#......D...C...#
#..............#
#..........C...#
#..............#
#...C..........#
#..............#
#..............#
#..............#
#...C.......C..#
#..............#
#..............#
#..............#
################
