NNNNNNNNNNNNNNNN
W..............E
W..............E
W......D.......E
W........C.....E
W..............E
W..............E
W...C...C......E
W......C.......E
W..............E
W........C.....E
W...C..........E
W..............E
W..............E
W..............E
SSSSSSSSSSSSSSSS
