NNNNNNNNNNNNNNNN
W..............E
W..C...........E
W......D...C...E
W..............E
W..........C...E
W..............E
W...C..........E
W..............E
W..............E
W..............E
W...C.......C..E
W..............E
W..............E
W..............E
SSSSSSSSSSSSSSSS
